28
............................
.....###########..........G.
.....###########............
.....###########............
..##############............
S.....##########............
......##########............
......##########............
......##########............
.....############...........
.....############...........
....#############...........
....##############..........
....####.#####..............
............................
............................
............................
............................
............................
............................
............................
............................
............................
............................
............................
............................
............................
............................
